11111111
1P01C001
11011011
1000C001
1E000001
11111111
