11111111111111111111111111111
1P0000C0000C00001110000000C01
10001111110001110001111111001
1000C000000000001000000000101
100010C00011111101111100C0001
10001111111111111111110000001
10000000100000000000000000001
11111110101111111101111111101
100000000C0110000000000000001
100011111111C0011111111111C01
10C00000000000000000000000001
11111110011111111111111111101
100000C0000C00000000000000001
10C000000000C000000C000000001
1C00000000000000000000000E001
11111111111111111111111111111
