11111
1P001
11001
1CE01
10001
10001
10001
11111
